1;1;1;1;1;1;1;1;1;1;1;1;1;1;1;1;1;1;1;1;1;1;1;1;1;1;1;1;1;1;1;1;1;1;1;1;1;1;1;1;1;1;1;1;1;1;1;1;1;1;1;1;1;1;1;1;1;1;1;1;1;1;1;1
1;1;1;1;1;1;1;1;1;1;1;1;1;1;1;1;1;1;1;1;1;1;1;1;1;1;1;1;1;1;1;1;1;1;1;1;1;1;1;1;1;1;1;1;1;1;1;1;1;1;1;1;1;1;1;1;1;1;1;1;1;1;1;1
1;1;1;1;1;1;1;1;1;1;1;1;1;1;1;1;1;1;1;1;1;1;1;1;1;1;1;1;1;1;1;1;1;1;1;1;1;1;1;1;1;1;1;1;1;1;1;1;1;1;1;1;1;1;1;1;1;1;1;1;1;1;1;1
1;1;1;1;1;1;1;1;1;1;1;1;1;1;1;1;1;1;1;1;1;1;1;1;1;1;1;1;1;1;1;1;1;1;1;1;1;1;1;1;1;1;1;1;1;1;1;1;1;1;1;1;1;1;1;1;1;1;1;1;1;1;1;1
1;1;1;1;1;1;1;1;1;1;1;1;1;1;1;1;1;1;1;1;1;1;1;1;1;1;1;1;1;1;1;1;1;1;1;1;1;1;1;1;1;1;1;1;1;1;1;1;1;1;1;1;1;1;1;1;1;1;1;1;1;1;1;1
1;1;1;1;1;1;1;1;1;1;1;1;1;1;1;1;1;1;1;1;1;1;1;1;1;1;1;1;1;1;1;1;1;1;1;1;1;1;1;1;1;1;1;1;1;1;1;1;1;1;1;1;1;1;1;1;1;1;1;1;1;1;1;1
1;1;1;1;1;1;1;1;1;1;1;1;1;1;1;1;1;1;1;1;1;1;1;1;1;1;1;12;12;12;12;12;12;12;12;12;12;12;12;12;12;12;12;1;1;1;1;1;1;1;1;1;1;1;1;1;1;1;1;1;1;1;1;1
1;1;1;1;1;1;1;1;1;1;1;1;1;1;1;1;1;1;1;1;1;1;1;1;1;1;1;12;12;12;12;10;12;12;12;12;12;10;12;12;12;12;12;1;1;1;1;1;1;1;1;1;1;1;1;1;1;1;1;1;1;1;1;1
1;1;1;1;1;1;1;1;1;1;1;1;1;1;1;1;1;1;1;1;1;1;1;1;1;1;1;12;12;143;143;143;143;143;143;143;143;143;143;143;12;12;12;12;12;12;1;1;1;1;1;1;1;1;1;1;1;1;1;1;1;1;1;1
1;1;1;1;1;1;113;113;113;113;1;1;1;1;1;1;1;1;1;2;2;1;2;2;3;1;1;12;10;143;143;143;143;143;143;143;143;143;143;143;10;12;12;12;12;12;1;1;1;1;1;1;1;1;1;1;1;1;1;1;1;1;1;1
1;1;1;1;1;1;113;113;113;113;1;1;1;1;1;1;1;2;142;142;142;142;142;142;142;142;142;142;12;143;143;143;143;143;143;143;143;143;143;143;12;142;142;142;12;12;1;1;1;1;1;1;1;1;1;1;1;1;1;1;1;1;1;1
1;1;1;1;1;1;113;113;113;113;113;1;1;1;1;1;1;1;142;142;142;142;142;142;142;142;142;142;90;143;143;143;143;143;143;143;143;143;143;143;90;142;106;142;10;12;1;1;1;1;1;1;1;1;1;1;1;1;1;1;1;1;1;1
1;1;1;1;1;1;113;113;113;113;113;1;1;1;1;1;1;2;142;142;142;142;142;142;142;142;142;142;12;143;143;143;143;143;143;143;143;143;143;143;12;142;142;142;12;12;1;1;1;1;1;1;1;1;1;1;1;1;1;1;1;1;1;1
1;1;1;1;1;1;2;6;1;2;4;2;1;6;1;1;1;1;142;142;142;1;1;1;3;1;1;12;11;143;143;143;143;143;143;143;143;143;143;143;11;12;12;12;12;12;1;1;1;1;1;1;1;1;1;1;1;1;1;1;1;1;1;1
1;1;1;1;1;2;113;113;113;113;113;113;113;113;113;2;1;1;142;142;142;1;1;1;1;1;1;12;12;143;143;143;143;143;143;143;143;143;143;143;12;12;12;12;12;12;1;1;1;1;1;1;1;1;1;1;1;1;1;1;1;1;1;1
1;1;1;1;1;3;113;113;113;113;113;113;113;113;113;3;1;2;142;142;142;1;2;1;1;1;1;12;12;12;12;10;12;12;91;12;12;10;12;12;12;12;1;1;1;1;1;1;1;1;1;1;1;1;1;1;1;1;1;1;1;1;1;1
1;1;1;1;1;1;113;113;113;113;113;113;113;113;113;2;142;142;142;142;142;142;142;1;1;1;1;12;12;12;12;12;12;110;110;110;12;12;12;12;12;12;1;1;1;1;1;1;1;1;1;1;1;1;1;1;1;1;1;1;1;1;1;1
1;1;1;1;1;2;113;113;113;113;113;113;113;113;113;90;142;142;142;142;142;142;142;1;1;1;1;1;1;1;12;12;12;110;110;110;12;12;12;12;12;12;1;1;1;1;1;1;1;1;1;1;1;1;1;1;1;1;1;1;1;1;1;1
2;2;2;2;1;1;113;113;113;113;113;113;113;113;113;1;142;142;142;142;142;142;142;1;1;1;1;1;1;1;12;12;11;110;110;110;11;12;1;1;1;1;1;1;1;1;1;1;1;1;1;1;1;1;1;1;1;1;1;1;1;1;1;1
1;2;1;2;1;3;113;113;113;113;113;113;113;113;113;3;1;2;1;6;1;2;1;1;2;1;1;1;1;1;12;12;12;110;110;110;12;12;1;1;1;1;1;1;1;1;1;1;1;1;1;1;1;1;1;1;1;1;1;1;1;1;1;1
2;117;117;117;1;1;113;113;113;113;113;113;113;113;113;1;1;1;1;1;1;1;1;1;1;1;12;12;12;12;12;12;12;110;110;110;12;12;12;12;1;1;1;1;1;1;1;1;1;1;1;1;1;1;1;1;1;1;1;1;1;1;1;1
1;117;117;117;2;1;2;6;1;1;91;1;1;6;2;1;1;1;1;1;1;1;1;1;1;1;12;12;12;12;12;12;12;110;110;110;12;12;12;12;1;1;1;1;1;1;1;1;1;1;1;1;1;1;1;1;1;1;1;1;1;1;1;1
1;117;117;117;1;1;1;1;1;141;141;141;2;1;1;1;1;1;1;1;1;1;1;1;1;1;12;12;110;110;10;106;110;110;110;110;110;110;12;12;1;1;1;1;1;1;1;1;1;1;1;1;1;1;1;1;1;1;1;1;1;1;1;1
2;1;91;1;1;1;1;1;3;141;141;141;3;1;1;1;1;1;1;1;1;1;1;1;1;1;12;12;110;110;12;12;12;110;110;110;12;12;12;12;1;1;1;1;1;1;1;1;1;1;1;1;1;1;1;1;1;1;1;1;1;1;1;1
1;114;114;114;1;1;2;1;1;141;141;141;2;1;1;1;1;1;1;1;1;1;1;1;1;1;12;12;110;110;12;12;12;110;110;110;12;12;12;12;1;1;1;1;1;1;1;1;1;1;1;1;1;1;1;1;1;1;1;1;1;1;1;1
1;114;114;114;2;114;114;114;1;141;141;141;1;1;1;1;1;1;1;1;1;1;1;1;1;1;12;12;110;110;12;12;12;110;110;110;12;12;12;12;1;1;1;1;1;1;1;1;1;1;1;1;1;1;1;1;1;1;1;1;1;1;1;1
1;114;114;114;114;114;114;114;3;141;141;141;3;1;1;1;1;1;1;1;1;1;1;1;1;1;12;12;12;12;12;12;10;110;110;110;10;12;1;1;1;1;1;1;1;1;1;1;1;1;1;1;1;1;1;1;1;1;1;1;1;1;1;1
1;114;114;114;1;114;114;114;2;141;141;141;1;1;1;1;1;1;1;1;1;1;1;1;1;1;12;12;12;12;12;12;12;110;110;110;12;12;1;1;1;1;1;1;1;1;1;1;1;1;1;1;9;9;9;9;9;9;9;9;9;9;9;9
2;114;114;114;1;2;1;2;1;1;91;1;1;2;1;1;1;1;1;1;1;1;1;1;1;1;1;1;1;1;1;1;12;10;91;10;12;2;2;2;2;2;2;2;1;1;1;1;1;1;1;1;9;8;8;9;8;8;8;9;9;9;8;9
3;114;114;114;3;1;112;112;112;112;112;112;112;112;112;1;1;1;1;1;1;1;1;1;1;1;2;1;2;1;3;2;108;108;108;108;108;1;3;1;2;1;1;2;1;1;1;1;1;1;1;1;9;8;139;139;139;139;139;139;139;139;8;9
2;114;114;114;1;2;112;112;112;112;112;112;112;112;112;3;1;1;1;1;1;1;1;1;1;1;1;108;108;108;108;108;108;108;108;108;108;108;108;108;108;108;2;2;9;9;9;9;9;9;9;9;9;8;139;139;139;139;139;139;139;139;9;9
1;114;114;114;1;2;112;112;112;112;112;112;112;112;112;1;1;1;1;1;1;1;1;1;1;1;6;108;108;108;108;108;108;108;108;108;108;108;108;108;108;108;6;9;8;8;8;9;8;8;8;9;9;8;139;139;139;139;139;139;139;139;8;9
1;114;114;114;114;1;112;112;112;112;112;112;112;112;112;2;1;1;1;1;1;1;1;1;1;1;1;108;108;108;108;108;108;108;108;108;108;108;108;108;108;108;108;9;111;111;111;111;111;111;111;111;111;8;139;139;139;139;139;139;139;139;9;9
1;114;114;114;114;90;112;112;112;112;112;112;112;112;112;3;1;1;1;1;1;1;1;1;1;1;2;108;108;108;108;108;108;108;108;108;108;108;108;108;108;108;108;90;111;111;111;111;111;111;111;111;111;90;139;139;139;139;139;139;139;139;5;9
1;114;114;114;114;1;112;112;112;112;112;112;112;112;112;1;1;1;1;1;1;1;1;1;1;1;2;108;108;108;108;108;108;108;108;108;108;108;108;108;108;108;108;8;111;111;111;111;111;111;111;111;111;9;139;139;139;139;139;139;139;139;9;9
1;114;114;114;1;1;112;112;112;112;112;112;112;112;112;2;2;1;1;1;1;1;1;1;1;1;6;108;108;108;108;108;108;108;108;108;108;108;108;108;108;108;6;8;8;8;111;111;111;111;9;9;8;8;139;139;139;139;139;139;139;139;8;9
2;114;114;114;1;1;112;112;112;112;112;112;112;112;112;3;1;1;1;1;1;1;1;1;1;1;2;108;108;108;108;108;108;108;108;108;108;108;108;108;108;108;2;2;2;8;8;111;111;8;8;8;8;9;139;139;139;139;139;139;139;139;9;9
1;114;114;114;1;1;112;112;112;112;112;112;112;112;112;1;1;1;1;1;1;1;1;1;1;1;1;1;4;1;2;1;108;108;108;108;108;1;2;4;1;2;1;2;1;8;9;111;111;9;8;8;9;8;139;139;139;139;139;139;139;139;8;9
4;114;114;114;4;1;2;1;1;2;91;1;1;2;2;1;1;1;1;1;1;1;1;1;1;1;1;1;1;1;1;1;8;8;91;9;8;8;2;2;2;2;2;2;1;8;9;111;111;8;8;9;9;9;9;8;139;9;8;139;9;8;9;9
1;114;114;114;2;1;1;1;1;114;114;114;1;1;1;1;1;1;1;1;1;1;1;1;1;1;1;1;1;1;1;8;8;108;108;108;9;8;1;1;1;1;1;1;1;8;8;111;111;9;8;9;9;9;8;9;9;9;9;9;9;9;9;9
1;114;114;114;1;1;1;1;2;114;114;114;2;1;1;1;1;1;1;1;1;1;1;1;1;1;1;1;1;1;1;8;9;108;108;108;9;8;1;1;1;1;1;1;1;8;9;111;111;8;8;9;9;9;9;9;9;9;9;9;9;9;9;9
2;114;114;114;1;114;114;114;1;114;114;114;1;1;1;1;1;1;1;1;1;1;1;1;1;1;1;1;1;1;1;8;8;108;108;108;9;8;1;1;1;1;1;1;1;8;8;111;111;9;8;8;8;8;8;8;8;8;8;8;8;8;1;1
1;114;114;114;114;114;114;114;3;114;114;114;3;1;1;1;1;1;1;1;1;1;1;1;1;1;1;1;1;1;1;8;9;108;108;108;8;8;1;1;1;1;1;1;1;8;9;111;111;8;8;9;118;8;118;9;118;9;118;8;9;8;1;1
2;114;114;114;2;114;114;114;2;114;114;114;2;1;1;1;1;1;1;1;1;1;1;1;1;1;1;1;1;1;1;8;9;108;108;108;9;8;1;1;1;1;1;1;1;8;8;111;111;111;8;118;118;118;118;118;118;118;118;118;8;8;1;1
2;114;114;114;1;1;2;1;1;114;114;114;2;1;1;1;1;2;1;1;1;1;1;1;1;1;1;1;1;1;1;8;8;108;108;108;8;8;1;1;1;1;1;1;1;8;8;111;111;111;90;118;118;118;118;118;118;118;118;118;5;8;1;1
1;114;114;114;2;1;2;1;2;114;114;114;1;2;1;2;2;3;1;2;1;6;2;1;2;1;1;1;1;1;1;8;9;108;108;108;8;9;1;1;1;1;1;1;1;8;9;111;111;111;8;118;118;118;118;118;118;118;118;118;8;8;1;1
2;114;114;114;114;114;114;114;114;114;114;114;114;114;114;114;114;2;140;140;140;140;140;140;3;21;1;1;1;1;1;8;8;108;108;108;9;8;1;1;1;1;1;1;1;8;8;9;8;8;8;9;118;8;118;8;118;8;118;8;9;8;1;1
2;114;114;114;114;114;114;114;114;114;114;114;114;114;114;114;114;90;140;140;140;140;140;140;100;140;21;1;1;1;1;8;9;108;108;108;9;8;1;1;1;1;1;1;1;8;8;8;8;8;8;8;8;8;8;8;8;8;8;8;8;8;1;1
1;114;114;114;114;114;114;114;114;114;114;114;114;114;114;114;114;1;140;140;140;140;140;106;3;21;1;1;1;1;1;8;9;108;108;108;8;8;1;1;1;1;1;1;1;1;1;1;1;1;1;1;1;1;1;1;1;1;1;1;1;1;1;1
1;2;2;1;2;2;1;2;2;1;4;1;1;1;2;1;1;1;1;2;1;6;1;2;1;1;2;1;8;8;8;8;8;108;108;108;9;8;8;8;8;8;8;1;1;1;1;1;1;1;1;1;1;1;1;1;1;1;1;1;1;1;1;1
1;1;1;1;1;1;1;1;1;1;21;3;140;140;1;140;140;1;140;140;1;1;1;1;1;1;1;8;8;9;8;9;8;8;91;8;8;8;8;8;9;8;8;1;1;1;1;1;1;1;1;1;1;1;1;1;1;1;1;1;1;1;1;1
1;1;1;1;1;1;1;1;1;21;140;100;140;140;1;140;140;1;140;2;1;1;1;1;1;1;8;9;109;109;109;109;8;109;109;109;8;109;109;109;109;9;8;1;1;1;1;1;1;1;1;1;1;1;1;1;1;1;1;1;1;1;1;1
1;1;1;1;1;1;1;1;1;1;21;3;140;140;140;140;140;1;1;1;1;1;1;1;1;1;8;8;109;109;109;109;90;109;109;109;90;109;109;109;109;9;8;1;1;1;1;1;1;1;1;1;1;1;1;1;1;1;1;1;1;1;1;1
1;1;1;1;1;1;1;1;1;1;1;1;1;1;1;1;1;1;1;1;1;1;1;1;1;1;8;8;109;109;109;109;8;109;109;109;8;109;109;109;109;9;8;1;1;1;1;1;1;1;1;1;1;1;1;1;1;1;1;1;1;1;1;1
1;1;1;1;1;1;1;1;1;1;1;1;1;140;140;1;1;1;1;1;1;1;1;1;1;1;8;9;109;109;109;109;9;109;109;109;9;109;109;109;109;9;8;1;1;1;1;1;1;1;1;1;1;1;1;1;1;1;1;1;1;1;1;1
1;1;1;1;1;1;1;1;1;1;1;1;1;140;140;1;1;1;1;1;1;1;1;1;1;1;8;8;8;9;8;8;9;109;109;109;8;8;8;8;8;8;8;1;1;1;1;1;1;1;1;1;1;1;1;1;1;1;1;1;1;1;1;1
1;1;1;1;1;1;1;1;1;1;1;1;1;1;1;1;1;1;1;1;1;1;1;1;1;1;8;8;109;109;109;109;8;109;109;109;8;109;109;109;109;8;8;1;1;1;1;1;1;1;1;1;1;1;1;1;1;1;1;1;1;1;1;1
1;1;1;1;1;1;1;1;1;1;1;1;1;1;1;1;1;1;1;1;1;1;1;1;1;1;8;9;109;109;109;109;90;109;109;109;90;109;109;109;109;9;8;1;1;1;1;1;1;1;1;1;1;1;1;1;1;1;1;1;1;1;1;1
1;1;1;1;1;1;1;1;1;1;1;1;1;1;1;1;1;1;1;1;1;1;1;1;1;1;8;8;109;109;109;109;8;109;109;109;8;109;109;109;109;8;8;1;1;1;1;1;1;1;1;1;1;1;1;1;1;1;1;1;1;1;1;1
1;1;1;1;1;1;1;1;1;1;1;1;1;1;1;1;1;1;1;1;1;1;1;1;1;1;8;8;9;9;8;8;9;109;109;109;9;8;8;9;8;8;8;1;1;1;1;1;1;1;1;1;1;1;1;1;1;1;1;1;1;1;1;1
1;1;1;1;1;1;1;1;1;1;1;1;1;1;1;1;1;1;1;1;1;1;1;1;1;1;8;8;109;109;109;109;109;109;109;109;109;109;109;109;109;8;8;1;1;1;1;1;1;1;1;1;1;1;1;1;1;1;1;1;1;1;1;1
1;1;1;1;1;1;1;1;1;1;1;1;1;1;1;1;1;1;1;1;1;1;1;1;1;1;8;9;109;109;109;109;109;109;109;109;109;109;109;109;109;8;8;1;1;1;1;1;1;1;1;1;1;1;1;1;1;1;1;1;1;1;1;1
1;1;1;1;1;1;1;1;1;1;1;1;1;1;1;1;1;1;1;1;1;1;1;1;1;1;8;8;109;109;109;109;109;109;109;109;109;109;109;109;109;8;8;1;1;1;1;1;1;1;1;1;1;1;1;1;1;1;1;1;1;1;1;1
1;1;1;1;1;1;1;1;1;1;1;1;1;1;1;1;1;1;1;1;1;1;1;1;1;1;8;8;5;9;8;5;8;9;7;8;9;5;9;8;5;8;8;1;1;1;1;1;1;1;1;1;1;1;1;1;1;1;1;1;1;1;1;1
